11111111111111111111
1P0000C0000CCCC000P1
10000CC000C0000C0001
1000C0C000C000C00001
100CCCCC00000C000001
100000C00000C0000001
100000C0000C00000001
100000C000CCCCCC0001
1PPPPPPPPPPPPPPPPPP1
10000000000000000001
10000000000000000001
100E0E0E0E0E0E0E0E01
10E0E0E0E0E0E0E0E001
10000000000000000001
10000111100111000001
10000100101000100001
10000111001000000001
10000100101011100001
10000111100111000001
11111111111111111111