111111
1CEEC1
1CCCC1
1CCCC1
1CPPC1
111111