111111
1EEEE1
1ECPE1
1ECCE1
1EEEE1
111111