11111111111111
1PC100C0001CP1
10010010001001
101100E0001101
10000000000001
10000000000001
1C1E00C000E1C1
10000000000001
10000000000001
111100E0001111
10010010001001
1PC000C0000CP1
11111111111111