1111111111111
110C00100C011
1P0000E0000P1
110C00100C011
1111111111111