11111111111111111111111111111111111111111111111111111111111111111111111
1P00000000000000000000000000000000C0000000000000000000000000000000000E1
1P00000000000000000000000000000000C0000000000000000000000000000000000E1
1P00000000000000000000000000000000C0000000000000000000000000000000000E1
1P00000000000000000000000000000000C0000000000000000000000000000000000E1
1P00000000000000000000000000000000C0000000000000000000000000000000000E1
1P00000000000000000000000000000000C0000000000000000000000000000000000E1
1P00000000000000000000000000000000C0000000000000000000000000000000000E1
1P00000000000000000000000000000000C0000000000000000000000000000000000E1
1P00000000000000000000000000000000C0000000000000000000000000000000000E1
1P00000000000000000000000000000000C0000000000000000000000000000000000E1
1P00000000000000000000000000000000C0000000000000000000000000000000000E1
1P00000000000000000000000000000000C0000000000000000000000000000000000E1
11111111111111111111111111111111111111111111111111111111111111111111111