1111111111111111
1P00000010C100C1
1000101110110101
11111C0000000001
1C00000111001111
1111000001C000C1
10010111E1110001
10C001C1000000P1
1111000000001111
1000011110011001
111P000C100000C1
1111111111111111