1111111111111111
1P10000000000001
101CCC1010000101
1001110000000001
1000000000000001
100000000010C001
10000100C1000101
1010000000000001
100000000C0C0001
1000000000001001
1000100010000001
1000000000000001
100000001000E001
1010000000000001
1000000000010001
1000000000000001
10C0000000000001
10000000100C0001
1000110000000011
1010000000000001
11000C0100000001
10000000100C0001
1010000000000001
1111111111111111