111111111111111
11P000000000011
100000000000001
10000CC0CC00001
1000C00C00C0001
100C0000000C001
100C000E000C001
1000C00000C0001
10000C000C00001
100000C0C000001
1100000C0000011
111111111111111