1111111111111111111111111111111111111111111111
1PC000000000000C000000C100000000000000C00000E1
1P0001000001000000100000001C0000000000000C00E1
1111111111111111111111111111111111111111111111