1111111
1P111P1
1011101
1011101
1011101
10CCC01
1011101
1011101
101E101
1011101
1E111E1
1111111