111111
1P0001
10CC01
10EP01
1E00E1
111111