11111111111111111111111111111
1P00E00000000C00000C0000000P1
10110100101000101001000010101
10110110101010001001000010101
1P00000C00C000000000000000CP1
11111111111111111111111111111