11111111111111111111111111111
1ECCCCCCCCCCCCCCCCCCCCCCCCCC1
1C11C1CC1C1CCC1C1CC1CCCC1C1C1
1C11C11C1C1C1CCC1CC1CCCC1C1C1
1PCCCCCCCCCCCCCCCCCCCCCCCCCC1
11111111111111111111111111111