11111111111111111111111111111
1E00000000000C00000C000000001
10110100101000101001000010101
10110110101010001001000010101
1P00000C00C0000000000000000C1
11111111111111111111111111111